00000000
00001000
00011000
00110000
00110110
00011100
00011000
00011000
00011000
00011000
00000000
00000000